type octile
height 105
width 105
map
@@@@@@@@@@@@@@@@@@@@@@@@@@@@@@@@@@@@@@@@@@@@@@@@@@@@@@@@@@@@@@@@@@@@@@@@@@@@@@@@@@@@@@@@@@@@@@@@@@@@@@@@@
@...................................................@...................................................@
@...................................................@...................................................@
@...................................................@...................................................@
@...................................................@...................................................@
@...................................................@...................................................@
@...................................................@...................................................@
@.......................................................................................................@
@...................................................@...................................................@
@...................................................@...................................................@
@...................................................@...................................................@
@...................................................@...................................................@
@...................................................@...................................................@
@...................................................@...................................................@
@...................................................@...................................................@
@.......................................................................................................@
@.......................................................................................................@
@.......................................................................................................@
@...................................................@...................................................@
@...................................................@...................................................@
@...................................................@...................................................@
@...................................................@...................................................@
@...................................................@...................................................@
@...................................................@...................................................@
@...................................................@...................................................@
@.......................................................................................................@
@.......................................................................................................@
@.......................................................................................................@
@.......................................................................................................@
@.......................................................................................................@
@...................................................@...................................................@
@...................................................@...................................................@
@...................................................@...................................................@
@...................................................@...................................................@
@...................................................@...................................................@
@...................................................@...................................................@
@...................................................@...................................................@
@...................................................@...................................................@
@...................................................@...................................................@
@...................................................@...................................................@
@...................................................@...................................................@
@...................................................@...................................................@
@.......................................................................................................@
@.......................................................................................................@
@.......................................................................................................@
@.......................................................................................................@
@.......................................................................................................@
@.......................................................................................................@
@.......................................................................................................@
@...................................................@...................................................@
@...................................................@...................................................@
@...................................................@...................................................@
@...................................................@...................................................@
@...................................................@...................................................@
@...................................................@...................................................@
@...................................................@...................................................@
@...................................................@...................................................@
@...................................................@...................................................@
@...................................................@...................................................@
@...................................................@...................................................@
@...................................................@...................................................@
@...................................................@...................................................@
@...................................................@...................................................@
@...................................................@...................................................@
@...................................................@...................................................@
@...................................................@...................................................@
@...................................................@...................................................@
@...................................................@...................................................@
@...................................................@...................................................@
@...................................................@...................................................@
@...................................................@...................................................@
@...................................................@...................................................@
@...................................................@...................................................@
@...................................................@...................................................@
@...................................................@...................................................@
@...................................................@...................................................@
@...................................................@...................................................@
@...................................................@...................................................@
@...................................................@...................................................@
@...................................................@...................................................@
@...................................................@...................................................@
@...................................................@...................................................@
@...................................................@...................................................@
@...................................................@...................................................@
@...................................................@...................................................@
@...................................................@...................................................@
@...................................................@...................................................@
@...................................................@...................................................@
@...................................................@...................................................@
@...................................................@...................................................@
@...................................................@...................................................@
@...................................................@...................................................@
@...................................................@...................................................@
@...................................................@...................................................@
@...................................................@...................................................@
@...................................................@...................................................@
@...................................................@...................................................@
@...................................................@...................................................@
@...................................................@...................................................@
@...................................................@...................................................@
@...................................................@...................................................@
@...................................................@...................................................@
@...................................................@...................................................@
@...................................................@...................................................@
@@@@@@@@@@@@@@@@@@@@@@@@@@@@@@@@@@@@@@@@@@@@@@@@@@@@@@@@@@@@@@@@@@@@@@@@@@@@@@@@@@@@@@@@@@@@@@@@@@@@@@@@@
