type octile
height 77
width 77
map
@@@@@@@@@@@@@@@@@@@@@@@@@@@@@@@@@@@@@@@@@@@@@@@@@@@@@@@@@@@@@@@@@@@@@@@@@@@@@
@...........................................@...............................@
@...........................................@...............................@
@...........................................@...............................@
@...........................................@...............................@
@...........................................@...............................@
@...........................................@...............................@
@...........................................@...............................@
@...........................................@...............................@
@...........................................@...............................@
@...........................................@...............................@
@...........................................@...............................@
@...........................................@...............................@
@...........................................@...............................@
@...........................................@...............................@
@...........................................@...............................@
@...........................................@...............................@
@...........................................@...............................@
@...........................................@...............................@
@...........................................@...............................@
@...........................................@...............................@
@...........................................@...............................@
@...........................................@...............................@
@...........................................@...............................@
@...........................................@...............................@
@...........................................@...............................@
@...........................................@...............................@
@...........................................@...............................@
@...........................................@...............................@
@...........................................@...............................@
@...........................................@...............................@
@...........................................@...............................@
@...........................................@...............................@
@...........................................................................@
@...........................................................................@
@...........................................................................@
@...........................................................................@
@...........................................................................@
@...........................................................................@
@...........................................................................@
@...........................................................................@
@...........................................................................@
@...........................................................................@
@...........................................................................@
@...........................................@...............................@
@...........................................@...............................@
@...........................................@...............................@
@...........................................@...............................@
@...........................................@...............................@
@...........................................@...............................@
@...........................................@...............................@
@...........................................@...............................@
@...........................................@...............................@
@...........................................@...............................@
@...........................................@...............................@
@...........................................@...............................@
@...........................................@...............................@
@...........................................@...............................@
@...........................................@...............................@
@...........................................@...............................@
@...........................................@...............................@
@...........................................@...............................@
@...........................................@...............................@
@...........................................@...............................@
@...........................................@...............................@
@...........................................@...............................@
@...........................................@...............................@
@...........................................@...............................@
@...........................................@...............................@
@...........................................@...............................@
@...........................................@...............................@
@...........................................@...............................@
@...........................................@...............................@
@...........................................@...............................@
@...........................................@...............................@
@...........................................@...............................@
@@@@@@@@@@@@@@@@@@@@@@@@@@@@@@@@@@@@@@@@@@@@@@@@@@@@@@@@@@@@@@@@@@@@@@@@@@@@@
